"filename", "language", "C#", "Razor", "comment", "blank", "total"
"c:\Users\Anuxa\source\repos\iWenJuan\iWenJuan.Client.WorkSpace\Components\App.razor", "Razor", 0, 2, 0, 1, 3
"c:\Users\Anuxa\source\repos\iWenJuan\iWenJuan.Client.WorkSpace\Components\Custom\FluentSelectEnum.razor", "Razor", 0, -51, 0, -7, -58
"c:\Users\Anuxa\source\repos\iWenJuan\iWenJuan.Client.WorkSpace\Components\Custom\FluentSelectEnumTmp.razor", "Razor", 0, 51, 0, 7, 58
"c:\Users\Anuxa\source\repos\iWenJuan\iWenJuan.Client.WorkSpace\Components\Pages\Data\DataManager.razor", "Razor", 0, 45, 0, 7, 52
"c:\Users\Anuxa\source\repos\iWenJuan\iWenJuan.Client.WorkSpace\Components\Pages\Data\DataPreviewer.razor", "Razor", 0, 4, 0, -3, 1
"c:\Users\Anuxa\source\repos\iWenJuan\iWenJuan.Client.WorkSpace\Components\Pages\Data\DataProcesser.razor", "Razor", 0, 129, 0, 18, 147
"c:\Users\Anuxa\source\repos\iWenJuan\iWenJuan.Client.WorkSpace\Components\Pages\Data\DataVisualizer.razor", "Razor", 0, -6, 0, 11, 5
"c:\Users\Anuxa\source\repos\iWenJuan\iWenJuan.Client.WorkSpace\Components\Pages\Survey\QuestionEditor.razor", "Razor", 0, 0, 0, -1, -1
"c:\Users\Anuxa\source\repos\iWenJuan\iWenJuan.Client.WorkSpace\Components\Pages\Survey\SurveyEditor.razor", "Razor", 0, 4, 0, 0, 4
"c:\Users\Anuxa\source\repos\iWenJuan\iWenJuan.Client.WorkSpace\Components\Pages\Survey\SurveyManager.razor", "Razor", 0, 5, 0, 1, 6
"c:\Users\Anuxa\source\repos\iWenJuan\iWenJuan.Service.DataProcessing\Controllers\CsvProcessingController.cs", "C#", -1, 0, 0, 0, -1
"c:\Users\Anuxa\source\repos\iWenJuan\iWenJuan.Service.DataProcessing\Interface\ICsvProcessingService.cs", "C#", 0, 0, 0, 1, 1
"c:\Users\Anuxa\source\repos\iWenJuan\iWenJuan.Service.DataProcessing\Models\CsvOperation.cs", "C#", -9, 0, 0, -3, -12
"c:\Users\Anuxa\source\repos\iWenJuan\iWenJuan.Service.DataProcessing\Services\CsvProcessingService.cs", "C#", 4, 0, 0, 0, 4
"c:\Users\Anuxa\source\repos\iWenJuan\iWenJuan.Service.DataStorage\Controllers\FileStorageController.cs", "C#", 12, 0, 14, 1, 27
"c:\Users\Anuxa\source\repos\iWenJuan\iWenJuan.Service.DataStorage\Interface\IFileStorageService.cs", "C#", 3, 0, 6, 2, 11
"c:\Users\Anuxa\source\repos\iWenJuan\iWenJuan.Service.DataStorage\Services\FileStorageService.cs", "C#", 19, 0, 9, 1, 29
"c:\Users\Anuxa\source\repos\iWenJuan\iWenJuan.Shared\Dtos\DataProcess\CsvOperation.cs", "C#", 9, 0, 0, 3, 12
"c:\Users\Anuxa\source\repos\iWenJuan\iWenJuan.Shared\Dtos\SurveyData\ExportSurveyResultDto.cs", "C#", 11, 0, 0, 4, 15
"c:\Users\Anuxa\source\repos\iWenJuan\iWenJuan.Shared\Enums\ChartType.cs", "C#", -28, 0, 0, -3, -31
"c:\Users\Anuxa\source\repos\iWenJuan\iWenJuan.Shared\Enums\CsvOperationType.cs", "C#", 11, 0, 0, 1, 12
"c:\Users\Anuxa\source\repos\iWenJuan\iWenJuan.Shared\Enums\IWenJuanChartType.cs", "C#", 28, 0, 0, 3, 31
"c:\Users\Anuxa\source\repos\iWenJuan\iWenJuan.Shared\Extension\ExpandoObjectExtension.cs", "C#", -7, 0, 0, -1, -8
"Total", "-", 52, 183, 29, 43, 307